//MAP CONVERTED BY dmm2tgm.py THIS HEADER COMMENT PREVENTS RECONVERSION, DO NOT REMOVE
"aW" = (
/turf/closed/indestructible/abductor,
/area/ruin/space/bluemoon/abductorcrush)
"bt" = (
/mob/living/simple_animal/hostile/syndicate/melee/sword/space/stormtrooper,
/turf/open/floor/plating/airless{
	icon_state = "platingdmg2"
	},
/area/ruin/space/bluemoon/abductorcrush)
"bW" = (
/turf/closed/wall/mineral/plastitanium/nodiagonal,
/area/ruin/space/has_grav)
"cO" = (
/obj/structure/fluff/broken_flooring{
	dir = 8;
	icon_state = "plating"
	},
/turf/open/space/basic,
/area/space)
"dx" = (
/turf/open/space/basic,
/area/space)
"ey" = (
/obj/effect/decal/cleanable/dirt,
/obj/effect/decal/cleanable/dirt,
/obj/structure/fluff/broken_flooring{
	icon_state = "singular"
	},
/obj/effect/decal/cleanable/blood,
/obj/effect/decal/cleanable/dirt,
/turf/open/floor/plating/airless,
/area/ruin/space/has_grav)
"eX" = (
/turf/closed/indestructible/abductor{
	icon_state = "alien3"
	},
/area/ruin/space/bluemoon/abductorcrush)
"fm" = (
/obj/item/gun/energy/alien{
	pin = null
	},
/turf/open/floor/plating/airless{
	icon_state = "platingdmg3"
	},
/area/ruin/space/bluemoon/abductorcrush)
"hb" = (
/obj/structure/lattice,
/mob/living/simple_animal/hostile/syndicate/ranged/shotgun/space/stormtrooper,
/turf/open/space/basic,
/area/space)
"hV" = (
/obj/structure/chair{
	dir = 4
	},
/obj/effect/decal/cleanable/blood,
/obj/effect/decal/cleanable/dirt,
/obj/effect/decal/cleanable/dirt,
/turf/open/floor/mineral/plastitanium/airless,
/area/ruin/space/has_grav)
"hX" = (
/turf/closed/indestructible/abductor{
	icon_state = "alien8"
	},
/area/ruin/space/bluemoon/abductorcrush)
"ia" = (
/obj/effect/decal/cleanable/dirt,
/obj/item/shard,
/obj/effect/decal/cleanable/dirt,
/obj/structure/salvage/computer,
/turf/open/floor/mineral/plastitanium/airless,
/area/ruin/space/has_grav)
"iH" = (
/obj/structure/girder/reinforced,
/turf/open/floor/plating/airless,
/area/ruin/space/bluemoon/abductorcrush)
"jv" = (
/turf/closed/indestructible/abductor{
	icon_state = "alien23"
	},
/area/ruin/space/bluemoon/abductorcrush)
"kA" = (
/obj/item/circuitboard/computer/teleporter,
/turf/open/floor/plating/airless,
/area/ruin/space/bluemoon/abductorcrush)
"mC" = (
/obj/structure/lattice,
/turf/open/space/basic,
/area/space)
"mM" = (
/obj/effect/decal/cleanable/dirt,
/turf/open/floor/plating/airless{
	icon_state = "platingdmg1"
	},
/area/ruin/space/bluemoon/abductorcrush)
"on" = (
/obj/structure/salvage/computer{
	dir = 1
	},
/obj/item/shard{
	icon_state = "medium"
	},
/turf/open/floor/plating/airless,
/area/ruin/space/bluemoon/abductorcrush)
"qT" = (
/turf/open/space/basic,
/area/ruin/space/bluemoon/abductorcrush)
"qY" = (
/obj/structure/girder/reinforced,
/turf/open/floor/plating/airless{
	icon_state = "platingdmg3"
	},
/area/ruin/space/has_grav)
"si" = (
/obj/effect/decal/cleanable/dirt,
/mob/living/simple_animal/hostile/gigachad_inteq/space,
/turf/open/floor/plating/airless{
	icon_state = "platingdmg1"
	},
/area/ruin/space/bluemoon/abductorcrush)
"sQ" = (
/obj/effect/decal/cleanable/dirt,
/turf/open/floor/plating/airless{
	icon_state = "platingdmg1"
	},
/area/ruin/space/has_grav)
"tk" = (
/obj/structure/table/abductor,
/turf/open/floor/plating/abductor,
/area/ruin/space/bluemoon/abductorcrush)
"tH" = (
/obj/effect/mob_spawn/human/abductor,
/turf/open/floor/plating/abductor,
/area/ruin/space/bluemoon/abductorcrush)
"vu" = (
/obj/structure/lattice,
/obj/item/screwdriver/abductor{
	pixel_x = -1;
	pixel_y = -1
	},
/turf/open/space/basic,
/area/space)
"wg" = (
/obj/structure/table_frame/abductor,
/turf/open/floor/plating/abductor,
/area/ruin/space/bluemoon/abductorcrush)
"wn" = (
/turf/closed/indestructible/abductor{
	icon_state = "alien15"
	},
/area/ruin/space/bluemoon/abductorcrush)
"xp" = (
/turf/template_noop,
/area/space)
"AK" = (
/turf/closed/indestructible/abductor{
	icon_state = "alien6"
	},
/area/ruin/space/bluemoon/abductorcrush)
"AW" = (
/obj/structure/fluff/broken_flooring{
	dir = 2;
	icon_state = "plating"
	},
/turf/open/space/basic,
/area/ruin/space/bluemoon/abductorcrush)
"BQ" = (
/mob/living/simple_animal/hostile/syndicate/ranged/shotgun/space/stormtrooper/anthro,
/turf/open/space/basic,
/area/space)
"CG" = (
/obj/item/stack/cable_coil/yellow{
	amount = 1
	},
/turf/open/floor/plating/airless{
	icon_state = "platingdmg3"
	},
/area/ruin/space/has_grav)
"DS" = (
/turf/closed/indestructible/abductor{
	icon_state = "alien7"
	},
/area/ruin/space/bluemoon/abductorcrush)
"Ff" = (
/turf/closed/indestructible/abductor{
	icon_state = "alien14"
	},
/area/ruin/space/bluemoon/abductorcrush)
"Fo" = (
/turf/closed/indestructible/abductor{
	icon_state = "alien24"
	},
/area/ruin/space/bluemoon/abductorcrush)
"Gp" = (
/turf/open/floor/plating/airless{
	icon_state = "platingdmg3"
	},
/area/ruin/space/has_grav)
"Hy" = (
/obj/machinery/abductor/gland_dispenser,
/turf/open/floor/plating/abductor,
/area/ruin/space/bluemoon/abductorcrush)
"Jo" = (
/obj/structure/girder/reinforced,
/turf/open/floor/plating/airless,
/area/space)
"Ln" = (
/obj/machinery/teleport/hub,
/turf/open/floor/plating/airless{
	icon_state = "panelscorched"
	},
/area/ruin/space/bluemoon/abductorcrush)
"LK" = (
/obj/structure/shuttle/engine/propulsion/burst{
	dir = 8
	},
/turf/closed/wall/mineral/plastitanium,
/area/ruin/space/has_grav)
"Nr" = (
/turf/closed/indestructible/abductor{
	icon_state = "alien18"
	},
/area/ruin/space/bluemoon/abductorcrush)
"NR" = (
/mob/living/simple_animal/hostile/syndicate/ranged/smg/space/stormtrooper,
/turf/open/floor/plating/airless{
	icon_state = "platingdmg3"
	},
/area/ruin/space/has_grav)
"Pw" = (
/obj/effect/decal/cleanable/dirt,
/turf/open/floor/plating/abductor,
/area/ruin/space/bluemoon/abductorcrush)
"Py" = (
/turf/closed/indestructible/abductor{
	icon_state = "alien21"
	},
/area/ruin/space/bluemoon/abductorcrush)
"PI" = (
/turf/closed/indestructible/abductor{
	icon_state = "alien4"
	},
/area/ruin/space/bluemoon/abductorcrush)
"Qd" = (
/obj/structure/girder/reinforced,
/turf/open/floor/plating/airless,
/area/ruin/space/has_grav)
"QK" = (
/obj/machinery/teleport/station,
/turf/open/floor/plating/airless,
/area/ruin/space/bluemoon/abductorcrush)
"RQ" = (
/obj/machinery/stasis,
/turf/open/floor/plating/abductor,
/area/ruin/space/bluemoon/abductorcrush)
"RW" = (
/turf/closed/indestructible/abductor{
	icon_state = "alien19"
	},
/area/ruin/space/bluemoon/abductorcrush)
"Sc" = (
/obj/effect/mob_spawn/human/abductor,
/turf/open/floor/plating/airless,
/area/ruin/space/bluemoon/abductorcrush)
"SK" = (
/obj/effect/decal/cleanable/dirt,
/turf/open/floor/plating/airless,
/area/ruin/space/has_grav)
"SX" = (
/turf/closed/wall/mineral/plastitanium,
/area/ruin/space/has_grav)
"Tl" = (
/obj/item/wrench/abductor,
/turf/open/floor/plating/airless{
	icon_state = "platingdmg3"
	},
/area/ruin/space/bluemoon/abductorcrush)
"Uj" = (
/obj/structure/lattice,
/obj/item/multitool/abductor{
	pixel_x = -8;
	pixel_y = -3
	},
/turf/open/space/basic,
/area/ruin/space/bluemoon/abductorcrush)
"UA" = (
/obj/structure/frame/computer,
/turf/open/floor/plating/airless,
/area/ruin/space/bluemoon/abductorcrush)
"VW" = (
/turf/open/floor/plating/airless{
	icon_state = "platingdmg2"
	},
/area/ruin/space/bluemoon/abductorcrush)
"WR" = (
/turf/closed/indestructible/abductor{
	icon_state = "alien10"
	},
/area/ruin/space/bluemoon/abductorcrush)

(1,1,1) = {"
xp
xp
xp
xp
xp
xp
xp
xp
xp
xp
xp
xp
dx
dx
dx
dx
dx
xp
xp
"}
(2,1,1) = {"
xp
xp
xp
xp
xp
xp
xp
xp
xp
xp
xp
dx
Qd
bW
SK
bW
qY
dx
xp
"}
(3,1,1) = {"
xp
xp
dx
dx
dx
dx
dx
dx
dx
xp
dx
LK
bW
ia
hV
CG
Gp
SX
dx
"}
(4,1,1) = {"
xp
Jo
dx
dx
Ff
iH
WR
AK
dx
dx
Gp
NR
Qd
Gp
ey
sQ
mC
Qd
dx
"}
(5,1,1) = {"
xp
dx
BQ
VW
Pw
si
Uj
DS
aW
dx
dx
Qd
dx
SX
mC
mC
dx
cO
dx
"}
(6,1,1) = {"
xp
dx
Py
UA
Tl
tk
qT
Hy
mC
mC
dx
dx
xp
dx
dx
xp
mC
xp
xp
"}
(7,1,1) = {"
xp
dx
iH
QK
tH
AW
fm
on
eX
dx
dx
xp
xp
xp
xp
xp
xp
xp
xp
"}
(8,1,1) = {"
xp
dx
jv
Ln
kA
Pw
Sc
RQ
PI
dx
xp
xp
xp
xp
xp
xp
xp
xp
xp
"}
(9,1,1) = {"
xp
dx
Fo
Nr
wg
mM
bt
hX
iH
dx
xp
xp
xp
xp
xp
xp
xp
xp
xp
"}
(10,1,1) = {"
xp
dx
dx
RW
wn
vu
mC
mC
dx
dx
mC
xp
xp
xp
xp
xp
xp
xp
xp
"}
(11,1,1) = {"
xp
xp
dx
dx
dx
dx
dx
dx
mC
xp
Jo
xp
xp
xp
xp
xp
xp
xp
xp
"}
(12,1,1) = {"
xp
xp
xp
xp
xp
xp
xp
xp
xp
xp
xp
xp
xp
xp
xp
xp
xp
xp
xp
"}
(13,1,1) = {"
xp
xp
xp
mC
hb
Jo
xp
xp
mC
xp
xp
xp
xp
xp
xp
xp
xp
xp
xp
"}
(14,1,1) = {"
xp
xp
xp
xp
xp
mC
xp
Jo
xp
xp
xp
xp
xp
xp
xp
xp
xp
xp
xp
"}
(15,1,1) = {"
xp
xp
xp
xp
xp
xp
xp
xp
xp
xp
xp
xp
xp
xp
xp
xp
xp
xp
xp
"}
